12	14
9	9	9	9	9	9	9	9	9	9	9	9
9	4	2	1	2	1	2	1	2	1	4	9
9	2	S	2	Monica	2	Fara	2	Chloe	L	1	9
9	E	2	1	0	1	0	1	0	1	3	9
9	0	0	0	0	0	0	0	0	0	0	9
9	1	2	E	0	0	0	0	0	1	S	9
9	0	0	0	0	0	0	0	0	0	0	9
9	0	0	0	0	0	0	0	0	0	0	9
9	0	0	0	0	0	0	0	0	0	0	9
9	0	0	0	0	0	0	0	0	0	0	9
9	0	0	0	0	0	0	0	0	0	0	9
9	0	0	0	0	0	0	0	0	0	0	9
9	0	0	0	0	0	0	0	0	0	0	9
9	0	0	0	0	0	0	0	0	0	0	9