12	14
9	9	9	9	9	9	9	9	9	9	9	9
9	1	2	3	S	5	5	4	Bryce	2	1	9
9	1	2	Monica	4	5	5	4	0	E	1	9
9	L	2	0	4	5	5	E	3	2	1	9
9	0	0	0	0	0	0	0	0	0	0	9
9	1	1	0	0	0	0	0	0	0	0	9
9	0	0	0	0	0	0	0	0	2	2	9
9	0	0	0	0	0	0	0	0	0	0	9
9	0	0	0	0	0	0	0	0	0	0	9
9	0	0	0	0	0	0	0	0	0	0	9
9	0	0	0	0	0	0	0	0	0	0	9
9	0	0	0	0	0	0	0	0	0	0	9
9	0	0	0	0	0	0	0	0	0	0	9
9	0	0	0	0	0	0	0	0	0	0	9