12	14
9	9	9	9	9	9	9	9	9	9	9	9
9	Monica	E	E	1	Chloe	5	1	3	2	S	9
9	0	2	Fara	0	0	Bryce	Ama	2	1	1	9
9	1	1	0	1	5	0	0	1	2	Matt	9
9	E	2	1	1	E	0	S	0	1	0	9
9	0	0	0	0	0	0	0	0	0	2	9
9	0	L	4	4	0	0	2	2	2	L	9
9	0	0	0	0	0	0	0	0	0	0	9
9	0	0	0	0	0	0	0	0	0	0	9
9	0	0	0	0	0	0	0	0	0	0	9
9	0	0	0	0	0	0	0	0	0	0	9
9	0	0	0	0	0	0	0	0	0	0	9
9	0	0	0	0	0	0	0	0	0	0	9
9	0	0	0	0	0	0	0	0	0	0	9